1111111111111111111111111111
1E00000000A0000C00000C0000C1
1010010100100000101001000001
1010010010101010001001000001
1P000000AC00C000000000000A01
1111111111111111111111111111